      CwCwwwwwwwwwC 
   CwwC x         CC
   x    x    G     x
CwwC    x     G    x
x G CwwwCwwwwwC    C
xG          B      C
x G CwwwCwwwwwC    C
CwwC    x    P     x
   x    x          x
   CwwC x         CC
      CwCwwwwwwwwwC 