      CwCwwwwwwwwwC
   CwwC x         CC
   x    x          x
CwwC    x          x
x G CwwwCwwwwwC    C
xG    M     B    P D
x G cwwwcwwwwwC    C
CwwC    x          x
   x    x          x
   CwwC x         CC
      CwCwwwwwwwwwC 