      CwCwwwwwwwwwC 
   CwwC x         CC
   x    x          x
CwwC    x          x
x G CwwwCwwwwwC    C
xG          B P    C
x G CwwwCwwwwwC    C
CwwC    x          x
   x    x          x
   CwwC x         CC
      CwCwwwwwwwwwC 