CCCCCCCwCwwwwwwwwwC 
CCCCwwC x         CC
CCCx    x    G     x
CwwC    x     G    x
x G CwwwCwwwwwC    C
xG          B      D
x G CwwwCwwwwwC    C
CwwC    x    P     x
CC x    x          x
CCCCwwC x         CC
CCCCCCCwCwwwwwwwwwCC 