CwwwwwwwwwwwwwwwwwwC
x  B    xPx     D  x
x       x x        x
x   G   x x  G     x 
x       x x        x
x       x x        x
x  M    x x     M  x
x       x x        x
x       x x        x
x      C   C       x
x                  x
CwwwwwwwwwwwwwwwwwwC