CwwwwwwwwwwwwwwwwwwC
xP                Dx
x   wwwwwwwwwwwwwC x
x   xM             x
x   x          H   x
x         B        x
x                  x
x   x           M  x
x   xM             x
x   xwwwwwwwwwwwwC x
x                 Gx
CwwwwwwwwwwwwwwwwwwC