CwwwwwwwwwwwwwwwwC
x       M       Cx
x  wwwwwwwwwwww  x
x    GGG         x
x  wwwwwwwwwwww  x
x       M        x
D Pwwwwwwwwwwww  x
x     GGG        x
x  wwwwwwwwwwww  x
x        B       x
x               Cx
CwwwwwwwwwwwwwwwwC