CwwwwwwwwwwwwwwwwwwC
xPC C C C C C C C Cx
xC C C C C C C C C x
x C C C C C C C C Cx
xC C C C C C B C C x
x C C CGC C C C C Cx
xC C C CGC C C C C x
x C C C C C C C C Cx
xC C C C C C C C C x
x C C C C C C C C Cx
xC C C C C C C C CDx
CwwwwwwwwwwwwwwwwwwC